***~€‚ƒ***
***„…†‡***
ˆŠŠŒŽ‘’ŠŠ•
_**˜™š›**œ
ž*´¤¢£Ÿµ*³
ž*¼½¾¿ÀÁ*³
ž*ÂÃÄÅÆÇ*³
ž**‹“”¡a*³
·¶¶¶¶¶¶¶¶¸
¹ºººººººº»