***~€‚ƒ***
***„…†‡***
ˆŠŠŒŽ‘’ŠŠ•
_**˜™š›**œ
ž**¦©¬°**³
ž**§ª®±**³
ž**¨«¯²**³
ž**‹“”¡**³
·¶¶¶¶¶¶¶¶¸
¹ºººººººº»